TDWS28XX	KEYWORD1
PixelBuffer	KEYWORD1
PixelDriver	KEYWORD1
Color	KEYWORD1
FlexPins	KEYWORD1
FLEXIO1	LITERAL1
FLEXIO2	LITERAL1
RGB	LITERAL1
GRB	LITERAL1
GRBW	LITERAL1
TRICOLOR	LITERAL1
QUADCOLOR	LITERAL1
SINGLE_BUFFER	LITERAL1
DOUBLE_BUFFER	LITERAL1
DOUBLE_BUFFER_CONTINUOUS	LITERAL1
rgb	KEYWORD2
grb	KEYWORD2
grbw	KEYWORD2
setChannelType	KEYWORD2
begin	KEYWORD2
flipBuffers	KEYWORD2
flushBuffer	KEYWORD2
bufferReady	KEYWORD2
setPixel	KEYWORD2
setActivePixel	KEYWORD2
setInactivePixel	KEYWORD2
getPixel	KEYWORD2
getActivePixel	KEYWORD2
getInactivePixel	KEYWORD2
getActiveBufferPtr	KEYWORD2
getInactiveBufferPtr	KEYWORD2
getBufferSize	KEYWORD2
